{
  "title": "Test Dungeon",
  "width": 19,
  "height": 19,
  "startX": 9,
  "startY": 5,
  "events": [],
  "tiles": [
    "###################",
    "###################",
    "###################",
    "###################",
    "###################",
    "########.....######",
    "########.....######",
    "########.....######",
    "#######......######",
    "#######......######",
    "#######......######",
    "########....#######",
    "########.#..#######",
    "###################",
    "###################",
    "###################",
    "###################",
    "###################",
    "###################"
  ]
}